date,district,deaths_reported,death_through_appeal,pending_deaths,death_cases_approved
2021-10-22,Alappuzha,2,1,0,3
2021-10-22,Ernakulam,8,45,0,53
2021-10-22,Idukki,9,12,0,21
2021-10-22,Kannur,23,36,0,59
2021-10-22,Kasaragod,1,2,1,4
2021-10-22,Kollam,8,0,0,8
2021-10-22,Kottayam,4,0,0,4
2021-10-22,Kozhikode,6,0,2,8
2021-10-22,Malappuram,6,6,0,12
2021-10-22,Palakkad,9,30,0,39
2021-10-22,Pathanamthitta,9,2,0,11
2021-10-22,Thiruvananthapuram,10,1,289,300
2021-10-22,Thrissur,4,36,0,40
2021-10-22,Wayanad,0,1,0,1
2021-10-22,total,99,172,292,563
2021-10-23,Alappuzha,0,12,0,12
2021-10-23,Ernakulam,9,57,0,66
2021-10-23,Idukki,0,0,10,10
2021-10-23,Kannur,6,19,0,25
2021-10-23,Kasaragod,0,5,0,5
2021-10-23,Kollam,1,13,0,14
2021-10-23,Kottayam,5,0,0,5
2021-10-23,Kozhikode,13,0,1,14
2021-10-23,Malappuram,4,14,0,18
2021-10-23,Palakkad,6,0,0,6
2021-10-23,Pathanamthitta,6,18,2,26
2021-10-23,Thiruvananthapuram,8,0,225,233
2021-10-23,Thrissur,7,0,0,7
2021-10-23,Wayanad,0,4,19,23
2021-10-23,total,65,142,257,464
2021-10-24,Alappuzha,0,0,5,5
2021-10-24,Ernakulam,6,0,31,37
2021-10-24,Idukki,0,0,7,7
2021-10-24,Kannur,0,39,0,39
2021-10-24,Kasaragod,1,27,0,28
2021-10-24,Kollam,25,0,19,44
2021-10-24,Kottayam,4,0,1,5
2021-10-24,Kozhikode,8,0,0,8
2021-10-24,Malappuram,5,15,0,20
2021-10-24,Palakkad,7,0,3,10
2021-10-24,Pathanamthitta,0,0,11,11
2021-10-24,Thiruvananthapuram,5,0,132,137
2021-10-24,Thrissur,8,0,0,8
2021-10-24,Wayanad,2,0,2,4
2021-10-24,total,71,81,211,363
2021-10-25,Alappuzha,2,0,37,39
2021-10-25,Ernakulam,9,0,16,25
2021-10-25,Idukki,0,0,4,4
2021-10-25,Kannur,6,0,20,26
2021-10-25,Kasaragod,1,1,0,2
2021-10-25,Kollam,2,0,3,5
2021-10-25,Kottayam,2,0,4,6
2021-10-25,Kozhikode,5,0,1,6
2021-10-25,Malappuram,3,8,3,14
2021-10-25,Palakkad,5,0,10,15
2021-10-25,Pathanamthitta,8,0,57,65
2021-10-25,Thiruvananthapuram,1,0,29,30
2021-10-25,Thrissur,8,0,11,19
2021-10-25,Wayanad,1,0,24,25
2021-10-25,total,53,9,219,281
2021-10-26,Alappuzha,3,0,17,20
2021-10-26,Ernakulam,7,0,136,143
2021-10-26,Idukki,10,0,4,14
2021-10-26,Kannur,1,0,0,1
2021-10-26,Kasaragod,0,4,1,5
2021-10-26,Kollam,4,0,2,6
2021-10-26,Kottayam,8,0,55,63
2021-10-26,Kozhikode,7,0,1,8
2021-10-26,Malappuram,6,0,0,6
2021-10-26,Palakkad,19,30,3,52
2021-10-26,Pathanamthitta,5,0,3,8
2021-10-26,Thiruvananthapuram,5,0,42,47
2021-10-26,Thrissur,13,17,76,106
2021-10-26,Wayanad,2,0,1,3
2021-10-26,total,90,51,341,482
2021-10-27,Alappuzha,13,10,0,23
2021-10-27,Ernakulam,9,0,90,99
2021-10-27,Idukki,0,0,0,0
2021-10-27,Kannur,12,0,6,18
2021-10-27,Kasaragod,0,5,0,5
2021-10-27,Kollam,3,57,0,60
2021-10-27,Kottayam,5,0,0,5
2021-10-27,Kozhikode,14,59,127,200
2021-10-27,Malappuram,2,0,5,7
2021-10-27,Palakkad,8,0,23,31
2021-10-27,Pathanamthitta,1,0,0,1
2021-10-27,Thiruvananthapuram,10,0,1,11
2021-10-27,Thrissur,16,68,78,162
2021-10-27,Wayanad,0,0,0,0
2021-10-27,total,93,199,330,622
2021-10-28,Alappuzha,2,0,55,57
2021-10-28,Ernakulam,13,0,11,24
2021-10-28,Idukki,0,23,0,23
2021-10-28,Kannur,0,0,163,163
2021-10-28,Kasaragod,0,6,0,6
2021-10-28,Kollam,12,66,0,78
2021-10-28,Kottayam,5,0,0,5
2021-10-28,Kozhikode,3,15,249,267
2021-10-28,Malappuram,4,0,17,21
2021-10-28,Palakkad,7,0,39,46
2021-10-28,Pathanamthitta,1,0,1,2
2021-10-28,Thiruvananthapuram,4,0,6,10
2021-10-28,Thrissur,4,0,0,4
2021-10-28,Wayanad,1,0,1,2
2021-10-28,total,56,110,542,708
2021-10-29,Alappuzha,6,47,0,53
2021-10-29,Ernakulam,13,0,191,204
2021-10-29,Idukki,9,20,0,29
2021-10-29,Kannur,5,6,70,81
2021-10-29,Kasaragod,0,2,8,10
2021-10-29,Kollam,3,0,0,3
2021-10-29,Kottayam,7,0,1,8
2021-10-29,Kozhikode,6,0,0,6
2021-10-29,Malappuram,3,0,0,3
2021-10-29,Palakkad,10,0,0,10
2021-10-29,Pathanamthitta,5,34,0,39
2021-10-29,Thiruvananthapuram,14,0,0,14
2021-10-29,Thrissur,5,0,6,11
2021-10-29,Wayanad,0,0,0,0
2021-10-29,total,86,109,276,471
2021-10-30,Alappuzha,1,34,0,35
2021-10-30,Ernakulam,7,0,229,236
2021-10-30,Idukki,0,0,0,0
2021-10-30,Kannur,7,5,0,12
2021-10-30,Kasaragod,0,0,3,3
2021-10-30,Kollam,9,0,0,9
2021-10-30,Kottayam,9,0,0,9
2021-10-30,Kozhikode,3,0,0,3
2021-10-30,Malappuram,7,0,2,9
2021-10-30,Palakkad,5,0,0,5
2021-10-30,Pathanamthitta,4,0,1,5
2021-10-30,Thiruvananthapuram,5,0,0,5
2021-10-30,Thrissur,5,0,22,27
2021-10-30,Wayanad,0,0,0,0
2021-10-30,total,62,39,257,358
2021-10-31,Alappuzha,0,0,1,1
2021-10-31,Ernakulam,4,0,7,11
2021-10-31,Idukki,0,0,1,1
2021-10-31,Kannur,0,0,0,0
2021-10-31,Kasaragod,0,0,0,0
2021-10-31,Kollam,0,0,0,0
2021-10-31,Kottayam,5,0,0,5
2021-10-31,Kozhikode,3,7,13,23
2021-10-31,Malappuram,0,0,48,48
2021-10-31,Palakkad,1,0,15,16
2021-10-31,Pathanamthitta,0,0,2,2
2021-10-31,Thiruvananthapuram,1,0,0,1
2021-10-31,Thrissur,0,0,59,59
2021-10-31,Wayanad,0,0,0,0
2021-10-31,total,14,7,146,167
2021-11-01,Alappuzha,32,0,0,32
2021-11-01,Ernakulam,2,34,5,41
2021-11-01,Idukki,4,0,0,4
2021-11-01,Kannur,0,12,60,72
2021-11-01,Kasaragod,0,0,0,0
2021-11-01,Kollam,5,0,0,5
2021-11-01,Kottayam,4,0,0,4
2021-11-01,Kozhikode,2,1,147,150
2021-11-01,Malappuram,0,0,4,4
2021-11-01,Palakkad,2,0,4,6
2021-11-01,Pathanamthitta,5,0,0,5
2021-11-01,Thiruvananthapuram,2,0,0,2
2021-11-01,Thrissur,17,0,10,27
2021-11-01,Wayanad,3,11,2,16
2021-11-01,total,78,58,232,368
2021-11-02,Alappuzha,2,0,0,2
2021-11-02,Ernakulam,8,55,35,98
2021-11-02,Idukki,0,0,0,0
2021-11-02,Kannur,0,0,31,31
2021-11-02,Kasaragod,0,0,1,1
2021-11-02,Kollam,7,0,0,7
2021-11-02,Kottayam,1,0,0,1
2021-11-02,Kozhikode,8,0,0,8
2021-11-02,Malappuram,5,0,7,12
2021-11-02,Palakkad,4,0,10,14
2021-11-02,Pathanamthitta,0,0,0,0
2021-11-02,Thiruvananthapuram,4,0,0,4
2021-11-02,Thrissur,4,0,3,7
2021-11-02,Wayanad,2,0,0,2
2021-11-02,total,45,55,87,187
2021-11-03,Alappuzha,3,0,0,3
2021-11-03,Ernakulam,8,0,52,60
2021-11-03,Idukki,3,13,0,16
2021-11-03,Kannur,0,0,8,8
2021-11-03,Kasaragod,0,4,7,11
2021-11-03,Kollam,3,56,0,59
2021-11-03,Kottayam,0,0,0,0
2021-11-03,Kozhikode,3,0,0,3
2021-11-03,Malappuram,5,0,5,10
2021-11-03,Palakkad,12,1,0,13
2021-11-03,Pathanamthitta,4,0,0,4
2021-11-03,Thiruvananthapuram,5,26,0,31
2021-11-03,Thrissur,5,139,0,144
2021-11-03,Wayanad,0,0,0,0
2021-11-03,total,51,239,72,362
2021-11-04,Alappuzha,0,3,0,3
2021-11-04,Ernakulam,7,0,13,20
2021-11-04,Idukki,0,0,0,0
2021-11-04,Kannur,0,0,0,0
2021-11-04,Kasaragod,2,4,7,13
2021-11-04,Kollam,1,53,0,54
2021-11-04,Kottayam,14,0,0,14
2021-11-04,Kozhikode,6,0,0,6
2021-11-04,Malappuram,4,0,1,5
2021-11-04,Palakkad,14,0,0,14
2021-11-04,Pathanamthitta,2,0,0,2
2021-11-04,Thiruvananthapuram,1,0,0,1
2021-11-04,Thrissur,0,0,0,0
2021-11-04,Wayanad,4,0,0,4
2021-11-04,total,55,60,21,136
2021-11-05,Alappuzha,5,25,0,30
2021-11-05,Ernakulam,10,1,89,100
2021-11-05,Idukki,7,0,0,7
2021-11-05,Kannur,0,16,5,21
2021-11-05,Kasaragod,1,5,3,9
2021-11-05,Kollam,6,0,0,6
2021-11-05,Kottayam,0,0,0,0
2021-11-05,Kozhikode,4,64,0,68
2021-11-05,Malappuram,3,0,25,28
2021-11-05,Palakkad,0,0,4,4
2021-11-05,Pathanamthitta,2,0,0,2
2021-11-05,Thiruvananthapuram,4,0,0,4
2021-11-05,Thrissur,4,0,31,35
2021-11-05,Wayanad,0,0,0,0
2021-11-05,total,46,111,157,314
2021-11-06,Alappuzha,0,29,0,29
2021-11-06,Ernakulam,7,26,105,138
2021-11-06,Idukki,0,0,0,0
2021-11-06,Kannur,0,2,0,2
2021-11-06,Kasaragod,0,0,1,1
2021-11-06,Kollam,21,73,0,94
2021-11-06,Kottayam,5,35,0,40
2021-11-06,Kozhikode,1,0,60,61
2021-11-06,Malappuram,2,0,20,22
2021-11-06,Palakkad,3,6,0,9
2021-11-06,Pathanamthitta,3,60,0,63
2021-11-06,Thiruvananthapuram,6,0,0,6
2021-11-06,Thrissur,2,0,0,2
2021-11-06,Wayanad,0,0,0,0
2021-11-06,total,50,231,186,467
2021-11-07,Alappuzha,0,0,0,0
2021-11-07,Ernakulam,6,0,7,13
2021-11-07,Idukki,3,0,0,3
2021-11-07,Kannur,0,0,43,43
2021-11-07,Kasaragod,0,0,19,19
2021-11-07,Kollam,2,0,0,2
2021-11-07,Kottayam,0,0,0,0
2021-11-07,Kozhikode,1,6,84,91
2021-11-07,Malappuram,1,0,0,1
2021-11-07,Palakkad,2,21,0,23
2021-11-07,Pathanamthitta,0,0,0,0
2021-11-07,Thiruvananthapuram,4,0,0,4
2021-11-07,Thrissur,0,0,0,0
2021-11-07,Wayanad,2,0,0,2
2021-11-07,total,21,27,153,201
2021-11-08,Alappuzha,5,7,0,12
2021-11-08,Ernakulam,2,44,0,46
2021-11-08,Idukki,0,0,0,0
2021-11-08,Kannur,28,61,0,89
2021-11-08,Kasaragod,1,0,0,1
2021-11-08,Kollam,1,0,0,1
2021-11-08,Kottayam,12,58,0,70
2021-11-08,Kozhikode,7,0,0,7
2021-11-08,Malappuram,2,7,0,9
2021-11-08,Palakkad,0,5,0,5
2021-11-08,Pathanamthitta,7,0,0,7
2021-11-08,Thiruvananthapuram,5,0,0,5
2021-11-08,Thrissur,7,0,0,7
2021-11-08,Wayanad,3,0,0,3
2021-11-08,total,80,182,0,262
2021-11-09,Alappuzha,0,16,0,16
2021-11-09,Ernakulam,3,124,0,127
2021-11-09,Idukki,1,0,0,1
2021-11-09,Kannur,0,0,0,0
2021-11-09,Kasaragod,4,11,0,15
2021-11-09,Kollam,17,49,0,66
2021-11-09,Kottayam,0,28,0,28
2021-11-09,Kozhikode,4,0,0,4
2021-11-09,Malappuram,3,62,0,65
2021-11-09,Palakkad,3,7,0,10
2021-11-09,Pathanamthitta,0,40,0,40
2021-11-09,Thiruvananthapuram,2,0,0,2
2021-11-09,Thrissur,6,0,0,6
2021-11-09,Wayanad,4,0,0,4
2021-11-09,total,47,337,0,384
2021-11-10,Alappuzha,4,9,0,13
2021-11-10,Ernakulam,6,63,0,69
2021-11-10,Idukki,0,9,0,9
2021-11-10,Kannur,0,0,0,0
2021-11-10,Kasaragod,2,5,0,7
2021-11-10,Kollam,3,0,0,3
2021-11-10,Kottayam,15,14,0,29
2021-11-10,Kozhikode,1,0,0,1
2021-11-10,Malappuram,7,21,0,28
2021-11-10,Palakkad,2,0,0,2
2021-11-10,Pathanamthitta,0,0,0,0
2021-11-10,Thiruvananthapuram,2,90,0,92
2021-11-10,Thrissur,6,0,0,6
2021-11-10,Wayanad,0,0,0,0
2021-11-10,total,48,211,0,259
2021-11-12,Alappuzha,0,30,0,30
2021-11-12,Ernakulam,10,139,0,149
2021-11-12,Idukki,0,8,0,8
2021-11-12,Kannur,0,0,0,0
2021-11-12,Kasaragod,0,5,0,5
2021-11-12,Kollam,11,83,0,94
2021-11-12,Kottayam,14,0,0,14
2021-11-12,Kozhikode,4,22,0,26
2021-11-12,Malappuram,0,4,0,4
2021-11-12,Palakkad,1,0,0,1
2021-11-12,Pathanamthitta,13,0,0,13
2021-11-12,Thiruvananthapuram,5,40,0,45
2021-11-12,Thrissur,1,81,0,82
2021-11-12,Wayanad,0,0,0,0
2021-11-12,total,59,412,0,471
2021-11-13,Alappuzha,0,18,0,18
2021-11-13,Ernakulam,4,5,0,9
2021-11-13,Idukki,0,0,0,0
2021-11-13,Kannur,0,0,0,0
2021-11-13,Kasaragod,0,0,0,0
2021-11-13,Kollam,0,47,0,47
2021-11-13,Kottayam,0,0,0,0
2021-11-13,Kozhikode,1,0,0,1
2021-11-13,Malappuram,0,1,0,1
2021-11-13,Palakkad,9,0,0,9
2021-11-13,Pathanamthitta,0,59,0,59
2021-11-13,Thiruvananthapuram,8,21,0,29
2021-11-13,Thrissur,1,0,0,1
2021-11-13,Wayanad,0,0,0,0
2021-11-13,total,23,151,0,174
2021-11-14,Alappuzha,5,8,0,13
2021-11-14,Ernakulam,8,2,0,10
2021-11-14,Idukki,0,0,0,0
2021-11-14,Kannur,0,0,0,0
2021-11-14,Kasaragod,1,0,0,1
2021-11-14,Kollam,10,0,0,10
2021-11-14,Kottayam,8,0,0,8
2021-11-14,Kozhikode,2,0,0,2
2021-11-14,Malappuram,3,0,0,3
2021-11-14,Palakkad,6,0,0,6
2021-11-14,Pathanamthitta,0,0,0,0
2021-11-14,Thiruvananthapuram,3,9,0,12
2021-11-14,Thrissur,0,0,0,0
2021-11-14,Wayanad,0,0,0,0
2021-11-14,total,46,19,0,65
2021-11-15,Alappuzha,2,15,0,17
2021-11-15,Ernakulam,29,4,0,33
2021-11-15,Idukki,6,16,0,22
2021-11-15,Kannur,0,2,0,2
2021-11-15,Kasaragod,0,7,0,7
2021-11-15,Kollam,0,0,0,0
2021-11-15,Kottayam,0,0,0,0
2021-11-15,Kozhikode,1,4,0,5
2021-11-15,Malappuram,9,0,0,9
2021-11-15,Palakkad,1,10,0,11
2021-11-15,Pathanamthitta,6,0,0,6
2021-11-15,Thiruvananthapuram,2,12,0,14
2021-11-15,Thrissur,1,0,0,1
2021-11-15,Wayanad,0,0,0,0
2021-11-15,total,57,70,0,127
2021-11-16,Alappuzha,1,15,0,16
2021-11-16,Ernakulam,7,0,0,7
2021-11-16,Idukki,0,6,0,6
2021-11-16,Kannur,0,0,0,0
2021-11-16,Kasaragod,3,14,0,17
2021-11-16,Kollam,6,86,0,92
2021-11-16,Kottayam,2,0,0,2
2021-11-16,Kozhikode,3,0,0,3
2021-11-16,Malappuram,2,0,0,2
2021-11-16,Palakkad,0,2,0,2
2021-11-16,Pathanamthitta,5,0,0,5
2021-11-16,Thiruvananthapuram,6,16,0,22
2021-11-16,Thrissur,2,0,0,2
2021-11-16,Wayanad,2,32,0,34
2021-11-16,total,39,171,0,210
2021-11-17,Alappuzha,0,21,0,21
2021-11-17,Ernakulam,10,45,0,55
2021-11-17,Idukki,0,9,0,9
2021-11-17,Kannur,0,0,0,0
2021-11-17,Kasaragod,1,2,0,3
2021-11-17,Kollam,6,84,0,90
2021-11-17,Kottayam,0,0,0,0
2021-11-17,Kozhikode,3,0,0,3
2021-11-17,Malappuram,1,23,0,24
2021-11-17,Palakkad,3,14,0,17
2021-11-17,Pathanamthitta,11,45,0,56
2021-11-17,Thiruvananthapuram,17,5,0,22
2021-11-17,Thrissur,6,79,0,85
2021-11-17,Wayanad,3,0,0,3
2021-11-17,total,61,327,0,388
2021-11-18,Alappuzha,7,1,0,8
2021-11-18,Ernakulam,4,66,0,70
2021-11-18,Idukki,3,22,0,25
2021-11-18,Kannur,8,14,0,22
2021-11-18,Kasaragod,0,0,0,0
2021-11-18,Kollam,5,0,0,5
2021-11-18,Kottayam,5,0,0,5
2021-11-18,Kozhikode,2,37,0,39
2021-11-18,Malappuram,4,0,0,4
2021-11-18,Palakkad,5,1,0,6
2021-11-18,Pathanamthitta,0,0,0,0
2021-11-18,Thiruvananthapuram,7,18,0,25
2021-11-18,Thrissur,1,162,0,163
2021-11-18,Wayanad,0,0,0,0
2021-11-18,total,51,321,0,372
2021-11-19,Alappuzha,26,37,0,63
2021-11-19,Ernakulam,10,0,0,10
2021-11-19,Idukki,0,7,0,7
2021-11-19,Kannur,0,79,0,79
2021-11-19,Kasaragod,0,4,0,4
2021-11-19,Kollam,3,0,0,3
2021-11-19,Kottayam,0,0,0,0
2021-11-19,Kozhikode,1,0,0,1
2021-11-19,Malappuram,0,24,0,24
2021-11-19,Palakkad,0,1,0,1
2021-11-19,Pathanamthitta,0,1,0,1
2021-11-19,Thiruvananthapuram,4,2,0,6
2021-11-19,Thrissur,4,0,0,4
2021-11-19,Wayanad,1,0,0,1
2021-11-19,total,49,155,0,204
2021-11-20,Alappuzha,5,33,0,38
2021-11-20,Ernakulam,2,0,0,2
2021-11-20,Idukki,0,4,0,4
2021-11-20,Kannur,0,21,0,21
2021-11-20,Kasaragod,0,0,0,0
2021-11-20,Kollam,8,108,0,116
2021-11-20,Kottayam,0,0,0,0
2021-11-20,Kozhikode,2,31,0,33
2021-11-20,Malappuram,0,4,0,4
2021-11-20,Palakkad,4,9,0,13
2021-11-20,Pathanamthitta,0,0,0,0
2021-11-20,Thiruvananthapuram,5,6,0,11
2021-11-20,Thrissur,1,0,0,1
2021-11-20,Wayanad,5,0,0,5
2021-11-20,total,32,216,0,248
2021-11-21,Alappuzha,0,0,0,0
2021-11-21,Ernakulam,0,0,0,0
2021-11-21,Idukki,0,0,0,0
2021-11-21,Kannur,0,1,0,1
2021-11-21,Kasaragod,0,9,0,9
2021-11-21,Kollam,3,78,0,81
2021-11-21,Kottayam,8,0,0,8
2021-11-21,Kozhikode,0,3,0,3
2021-11-21,Malappuram,0,0,0,0
2021-11-21,Palakkad,4,9,0,13
2021-11-21,Pathanamthitta,13,45,0,58
2021-11-21,Thiruvananthapuram,11,11,0,22
2021-11-21,Thrissur,0,0,0,0
2021-11-21,Wayanad,1,0,0,1
2021-11-21,total,40,156,0,196
2021-11-22,Alappuzha,59,21,0,80
2021-11-22,Ernakulam,2,39,0,41
2021-11-22,Idukki,0,0,0,0
2021-11-22,Kannur,0,0,0,0
2021-11-22,Kasaragod,0,0,0,0
2021-11-22,Kollam,8,0,0,8
2021-11-22,Kottayam,0,0,0,0
2021-11-22,Kozhikode,3,9,0,12
2021-11-22,Malappuram,0,0,0,0
2021-11-22,Palakkad,1,0,0,1
2021-11-22,Pathanamthitta,0,0,0,0
2021-11-22,Thiruvananthapuram,0,2,0,2
2021-11-22,Thrissur,0,34,0,34
2021-11-22,Wayanad,2,0,0,2
2021-11-22,total,75,105,0,180
2021-11-23,Alappuzha,0,27,0,27
2021-11-23,Ernakulam,5,31,0,36
2021-11-23,Idukki,0,0,0,0
2021-11-23,Kannur,0,1,0,1
2021-11-23,Kasaragod,0,0,0,0
2021-11-23,Kollam,11,133,0,144
2021-11-23,Kottayam,0,25,0,25
2021-11-23,Kozhikode,2,0,0,2
2021-11-23,Malappuram,7,0,0,7
2021-11-23,Palakkad,6,30,0,36
2021-11-23,Pathanamthitta,0,45,0,45
2021-11-23,Thiruvananthapuram,18,11,0,29
2021-11-23,Thrissur,8,0,0,8
2021-11-23,Wayanad,0,10,0,10
2021-11-23,total,57,313,0,370
2021-11-24,Alappuzha,2,45,0,47
2021-11-24,Ernakulam,3,57,0,60
2021-11-24,Idukki,2,7,0,9
2021-11-24,Kannur,0,0,0,0
2021-11-24,Kasaragod,1,4,0,5
2021-11-24,Kollam,5,0,0,5
2021-11-24,Kottayam,7,79,0,86
2021-11-24,Kozhikode,3,0,0,3
2021-11-24,Malappuram,1,29,0,30
2021-11-24,Palakkad,0,22,0,22
2021-11-24,Pathanamthitta,0,0,0,0
2021-11-24,Thiruvananthapuram,6,30,0,36
2021-11-24,Thrissur,3,0,0,3
2021-11-24,Wayanad,2,0,0,2
2021-11-24,total,35,273,0,308
2021-11-25,Alappuzha,1,28,0,29
2021-11-25,Ernakulam,8,10,0,18
2021-11-25,Idukki,6,21,0,27
2021-11-25,Kannur,0,78,0,78
2021-11-25,Kasaragod,0,0,0,0
2021-11-25,Kollam,9,0,0,9
2021-11-25,Kottayam,6,78,0,84
2021-11-25,Kozhikode,1,69,0,70
2021-11-25,Malappuram,0,0,0,0
2021-11-25,Palakkad,4,11,0,15
2021-11-25,Pathanamthitta,7,0,0,7
2021-11-25,Thiruvananthapuram,13,33,0,46
2021-11-25,Thrissur,1,0,0,1
2021-11-25,Wayanad,0,0,0,0
2021-11-25,total,56,328,0,384
2021-11-26,Alappuzha,2,15,0,17
2021-11-26,Ernakulam,4,5,0,9
2021-11-26,Idukki,0,10,0,10
2021-11-26,Kannur,0,62,0,62
2021-11-26,Kasaragod,0,0,0,0
2021-11-26,Kollam,5,0,0,5
2021-11-26,Kottayam,0,58,0,58
2021-11-26,Kozhikode,2,0,0,2
2021-11-26,Malappuram,3,31,0,34
2021-11-26,Palakkad,8,25,0,33
2021-11-26,Pathanamthitta,0,1,0,1
2021-11-26,Thiruvananthapuram,5,35,0,40
2021-11-26,Thrissur,4,113,0,117
2021-11-26,Wayanad,0,0,0,0
2021-11-26,total,33,355,0,388
2021-11-27,Alappuzha,0,31,0,31
2021-11-27,Ernakulam,4,29,0,33
2021-11-27,Idukki,0,0,0,0
2021-11-27,Kannur,0,17,0,17
2021-11-27,Kasaragod,0,6,0,6
2021-11-27,Kollam,6,156,0,162
2021-11-27,Kottayam,0,60,0,60
2021-11-27,Kozhikode,3,0,0,3
2021-11-27,Malappuram,0,50,0,50
2021-11-27,Palakkad,4,19,0,23
2021-11-27,Pathanamthitta,0,43,0,43
2021-11-27,Thiruvananthapuram,6,9,0,15
2021-11-27,Thrissur,3,103,0,106
2021-11-27,Wayanad,2,3,0,5
2021-11-27,total,28,526,0,554
2021-11-29,Alappuzha,3,21,0,24
2021-11-29,Ernakulam,3,0,0,3
2021-11-29,Idukki,0,0,0,0
2021-11-29,Kannur,0,21,0,21
2021-11-29,Kasaragod,0,0,0,0
2021-11-29,Kollam,3,0,0,3
2021-11-29,Kottayam,17,0,0,17
2021-11-29,Kozhikode,5,0,0,5
2021-11-29,Malappuram,9,0,0,9
2021-11-29,Palakkad,1,0,0,1
2021-11-29,Pathanamthitta,0,0,0,0
2021-11-29,Thiruvananthapuram,7,16,0,23
2021-11-29,Thrissur,8,0,0,8
2021-11-29,Wayanad,3,0,0,3
2021-11-29,total,59,58,0,117
2021-11-30,Alappuzha,0,21,0,21
2021-11-30,Ernakulam,0,0,0,0
2021-11-30,Idukki,0,12,0,12
2021-11-30,Kannur,0,9,0,9
2021-11-30,Kasaragod,2,7,0,9
2021-11-30,Kollam,5,0,0,5
2021-11-30,Kottayam,0,0,0,0
2021-11-30,Kozhikode,0,0,0,0
2021-11-30,Malappuram,2,0,0,2
2021-11-30,Palakkad,0,2,0,2
2021-11-30,Pathanamthitta,0,79,0,79
2021-11-30,Thiruvananthapuram,3,28,0,31
2021-11-30,Thrissur,7,0,0,7
2021-11-30,Wayanad,0,0,0,0
2021-11-30,total,19,158,0,177
2021-12-01,Alappuzha,5,6,0,11
2021-12-01,Ernakulam,4,0,0,4
2021-12-01,Idukki,5,18,0,23
2021-12-01,Kannur,31,41,0,72
2021-12-01,Kasaragod,0,8,0,8
2021-12-01,Kollam,8,185,0,193
2021-12-01,Kottayam,0,0,0,0
2021-12-01,Kozhikode,4,0,0,4
2021-12-01,Malappuram,14,0,0,14
2021-12-01,Palakkad,3,11,0,14
2021-12-01,Pathanamthitta,7,0,0,7
2021-12-01,Thiruvananthapuram,7,38,0,45
2021-12-01,Thrissur,6,0,0,6
2021-12-01,Wayanad,2,0,0,2
2021-12-01,total,96,307,0,403
2021-12-02,Alappuzha,2,6,0,8
2021-12-02,Ernakulam,12,0,0,12
2021-12-02,Idukki,1,22,0,23
2021-12-02,Kannur,15,60,0,75
2021-12-02,Kasaragod,0,8,0,8
2021-12-02,Kollam,4,0,0,4
2021-12-02,Kottayam,11,0,0,11
2021-12-02,Kozhikode,0,0,0,0
2021-12-02,Malappuram,9,0,0,9
2021-12-02,Palakkad,0,31,0,31
2021-12-02,Pathanamthitta,2,0,0,2
2021-12-02,Thiruvananthapuram,6,44,0,50
2021-12-02,Thrissur,4,83,0,87
2021-12-02,Wayanad,0,0,0,0
2021-12-02,total,66,254,0,320
2021-12-03,Alappuzha,0,23,0,23
2021-12-03,Ernakulam,5,21,0,26
2021-12-03,Idukki,0,2,0,2
2021-12-03,Kannur,0,2,0,2
2021-12-03,Kasaragod,0,,0,0
2021-12-03,Kollam,8,,0,8
2021-12-03,Kottayam,9,,0,9
2021-12-03,Kozhikode,1,38,0,39
2021-12-03,Malappuram,0,1,0,1
2021-12-03,Palakkad,9,41,0,50
2021-12-03,Pathanamthitta,3,,0,3
2021-12-03,Thiruvananthapuram,6,26,0,32
2021-12-03,Thrissur,1,69,0,70
2021-12-03,Wayanad,2,2,0,4
2021-12-03,total,44,225,0,269
2021-12-04,Alappuzha,0,33,0,33
2021-12-04,Ernakulam,5,38,0,43
2021-12-04,Idukki,0,0,0,0
2021-12-04,Kannur,0,1,0,1
2021-12-04,Kasaragod,3,3,0,6
2021-12-04,Kollam,16,92,0,108
2021-12-04,Kottayam,8,0,0,8
2021-12-04,Kozhikode,0,20,0,20
2021-12-04,Malappuram,0,0,0,0
2021-12-04,Palakkad,4,40,0,44
2021-12-04,Pathanamthitta,2,0,0,2
2021-12-04,Thiruvananthapuram,8,20,0,28
2021-12-04,Thrissur,3,0,0,3
2021-12-04,Wayanad,3,16,0,19
2021-12-04,total,52,263,0,315
2021-12-05,Alappuzha,0,14,0,14
2021-12-05,Ernakulam,10,23,0,33
2021-12-05,Idukki,0,0,0,0
2021-12-05,Kannur,0,0,0,0
2021-12-05,Kasaragod,0,10,0,10
2021-12-05,Kollam,4,11,0,15
2021-12-05,Kottayam,3,0,0,3
2021-12-05,Kozhikode,0,0,0,0
2021-12-05,Malappuram,0,0,0,0
2021-12-05,Palakkad,1,52,0,53
2021-12-05,Pathanamthitta,0,0,0,0
2021-12-05,Thiruvananthapuram,4,28,0,32
2021-12-05,Thrissur,0,0,0,0
2021-12-05,Wayanad,1,0,0,1
2021-12-05,total,23,138,0,161
2021-12-06,Alappuzha,0,44,0,44
2021-12-06,Ernakulam,5,0,0,5
2021-12-06,Idukki,0,14,0,14
2021-12-06,Kannur,0,0,0,0
2021-12-06,Kasaragod,2,17,0,19
2021-12-06,Kollam,1,0,0,1
2021-12-06,Kottayam,0,42,0,42
2021-12-06,Kozhikode,3,0,0,3
2021-12-06,Malappuram,0,0,0,0
2021-12-06,Palakkad,7,11,0,18
2021-12-06,Pathanamthitta,0,0,0,0
2021-12-06,Thiruvananthapuram,8,10,0,18
2021-12-06,Thrissur,1,0,0,1
2021-12-06,Wayanad,3,0,0,3
2021-12-06,total,30,138,0,168
2021-12-07,Alappuzha,0,1,0,1
2021-12-07,Ernakulam,0,0,0,0
2021-12-07,Idukki,2,0,0,2
2021-12-07,Kannur,0,0,0,0
2021-12-07,Kasaragod,3,5,0,8
2021-12-07,Kollam,7,0,0,7
2021-12-07,Kottayam,0,59,0,59
2021-12-07,Kozhikode,3,0,0,3
2021-12-07,Malappuram,0,0,0,0
2021-12-07,Palakkad,1,28,0,29
2021-12-07,Pathanamthitta,2,0,0,2
2021-12-07,Thiruvananthapuram,7,13,0,20
2021-12-07,Thrissur,3,0,0,3
2021-12-07,Wayanad,0,0,0,0
2021-12-07,total,28,106,0,134
2021-12-08,Alappuzha,0,0,0,0
2021-12-08,Ernakulam,6,0,0,6
2021-12-08,Idukki,0,0,0,0
2021-12-08,Kannur,0,0,0,0
2021-12-08,Kasaragod,0,0,0,0
2021-12-08,Kollam,6,0,0,6
2021-12-08,Kottayam,3,30,0,33
2021-12-08,Kozhikode,3,0,0,3
2021-12-08,Malappuram,0,0,0,0
2021-12-08,Palakkad,6,30,0,36
2021-12-08,Pathanamthitta,2,0,0,2
2021-12-08,Thiruvananthapuram,8,17,0,25
2021-12-08,Thrissur,1,0,0,1
2021-12-08,Wayanad,0,0,0,0
2021-12-08,total,35,77,0,112
2021-12-09,Alappuzha,6,8,0,14
2021-12-09,Ernakulam,5,0,0,5
2021-12-09,Idukki,7,0,0,7
2021-12-09,Kannur,1,0,0,1
2021-12-09,Kasaragod,1,6,0,7
2021-12-09,Kollam,8,0,0,8
2021-12-09,Kottayam,4,34,0,38
2021-12-09,Kozhikode,0,0,0,0
2021-12-09,Malappuram,2,10,0,12
2021-12-09,Palakkad,4,16,0,20
2021-12-09,Pathanamthitta,2,68,0,70
2021-12-09,Thiruvananthapuram,7,31,0,38
2021-12-09,Thrissur,3,0,0,3
2021-12-09,Wayanad,2,0,0,2
2021-12-09,total,52,173,0,225
2021-12-10,Alappuzha,8,14,0,22
2021-12-10,Ernakulam,7,14,0,21
2021-12-10,Idukki,0,0,0,0
2021-12-10,Kannur,0,4,0,4
2021-12-10,Kasaragod,0,4,0,4
2021-12-10,Kollam,1,94,0,95
2021-12-10,Kottayam,2,10,0,12
2021-12-10,Kozhikode,2,34,0,36
2021-12-10,Malappuram,0,20,0,20
2021-12-10,Palakkad,2,24,0,26
2021-12-10,Pathanamthitta,0,0,0,0
2021-12-10,Thiruvananthapuram,5,8,0,13
2021-12-10,Thrissur,4,83,0,87
2021-12-10,Wayanad,0,0,0,0
2021-12-10,total,31,309,0,340
2021-12-11,Alappuzha,5,0,0,5
2021-12-11,Ernakulam,21,44,0,65
2021-12-11,Idukki,0,0,0,0
2021-12-11,Kannur,0,0,0,0
2021-12-11,Kasaragod,0,0,0,0
2021-12-11,Kollam,5,0,0,5
2021-12-11,Kottayam,3,34,0,37
2021-12-11,Kozhikode,2,0,0,2
2021-12-11,Malappuram,8,0,0,8
2021-12-11,Palakkad,1,1,0,2
2021-12-11,Pathanamthitta,1,0,0,1
2021-12-11,Thiruvananthapuram,4,21,0,25
2021-12-11,Thrissur,0,85,0,85
2021-12-11,Wayanad,0,10,0,10
2021-12-11,total,50,195,0,245
2021-12-12,Alappuzha,0,0,0,0
2021-12-12,Ernakulam,0,39,0,39
2021-12-12,Idukki,0,0,0,0
2021-12-12,Kannur,0,0,0,0
2021-12-12,Kasaragod,0,0,0,0
2021-12-12,Kollam,3,0,0,3
2021-12-12,Kottayam,6,65,0,71
2021-12-12,Kozhikode,0,0,0,0
2021-12-12,Malappuram,21,0,0,21
2021-12-12,Palakkad,1,0,0,1
2021-12-12,Pathanamthitta,0,0,0,0
2021-12-12,Thiruvananthapuram,3,5,0,8
2021-12-12,Thrissur,0,0,0,0
2021-12-12,Wayanad,0,0,0,0
2021-12-12,total,34,109,0,143
2021-12-13,Alappuzha,0,6,0,6
2021-12-13,Ernakulam,5,0,0,5
2021-12-13,Idukki,0,5,0,5
2021-12-13,Kannur,6,58,0,64
2021-12-13,Kasaragod,2,0,0,2
2021-12-13,Kollam,4,0,0,4
2021-12-13,Kottayam,1,89,0,90
2021-12-13,Kozhikode,0,0,0,0
2021-12-13,Malappuram,0,1,0,1
2021-12-13,Palakkad,3,6,0,9
2021-12-13,Pathanamthitta,1,0,0,1
2021-12-13,Thiruvananthapuram,7,0,0,7
2021-12-13,Thrissur,9,0,0,9
2021-12-13,Wayanad,0,0,0,0
2021-12-13,total,38,165,0,203
2021-12-14,Alappuzha,0,5,0,5
2021-12-14,Ernakulam,0,0,0,0
2021-12-14,Idukki,7,16,0,23
2021-12-14,Kannur,2,49,0,51
2021-12-14,Kasaragod,0,12,0,12
2021-12-14,Kollam,0,0,0,0
2021-12-14,Kottayam,0,3,0,3
2021-12-14,Kozhikode,3,0,0,3
2021-12-14,Malappuram,0,0,0,0
2021-12-14,Palakkad,3,15,0,18
2021-12-14,Pathanamthitta,3,17,0,20
2021-12-14,Thiruvananthapuram,4,29,0,33
2021-12-14,Thrissur,3,0,0,3
2021-12-14,Wayanad,3,0,0,3
2021-12-14,total,28,146,0,174
2021-12-15,Alappuzha,6,14,0,20
2021-12-15,Ernakulam,13,2,0,15
2021-12-15,Idukki,10,0,0,10
2021-12-15,Kannur,9,0,0,9
2021-12-15,Kasaragod,1,0,0,1
2021-12-15,Kollam,13,0,0,13
2021-12-15,Kottayam,1,19,0,20
2021-12-15,Kozhikode,2,19,0,21
2021-12-15,Malappuram,1,29,0,30
2021-12-15,Palakkad,0,17,0,17
2021-12-15,Pathanamthitta,0,7,0,7
2021-12-15,Thiruvananthapuram,57,17,0,74
2021-12-15,Thrissur,4,0,0,4
2021-12-15,Wayanad,8,33,0,41
2021-12-15,total,125,157,0,282
2021-12-16,Alappuzha,0,170,0,170
2021-12-16,Ernakulam,15,0,0,15
2021-12-16,Idukki,0,19,0,19
2021-12-16,Kannur,5,15,0,20
2021-12-16,Kasaragod,0,0,0,0
2021-12-16,Kollam,2,0,0,2
2021-12-16,Kottayam,1,0,0,1
2021-12-16,Kozhikode,3,0,0,3
2021-12-16,Malappuram,1,72,0,73
2021-12-16,Palakkad,1,5,0,6
2021-12-16,Pathanamthitta,0,0,0,0
2021-12-16,Thiruvananthapuram,4,3,0,7
2021-12-16,Thrissur,4,0,0,4
2021-12-16,Wayanad,0,0,0,0
2021-12-16,total,36,284,0,320
2021-12-17,Alappuzha,2,4,0,6
2021-12-17,Ernakulam,4,0,0,4
2021-12-17,Idukki,5,0,0,5
2021-12-17,Kannur,1,8,0,9
2021-12-17,Kasaragod,0,0,0,0
2021-12-17,Kollam,0,0,0,0
2021-12-17,Kottayam,2,34,0,36
2021-12-17,Kozhikode,0,0,0,0
2021-12-17,Malappuram,0,70,0,70
2021-12-17,Palakkad,0,0,0,0
2021-12-17,Pathanamthitta,1,0,0,1
2021-12-17,Thiruvananthapuram,1,17,0,18
2021-12-17,Thrissur,4,86,0,90
2021-12-17,Wayanad,2,2,0,4
2021-12-17,total,22,221,0,243
2021-12-18,Alappuzha,1,23,0,24
2021-12-18,Ernakulam,7,0,0,7
2021-12-18,Idukki,0,0,0,0
2021-12-18,Kannur,12,0,0,12
2021-12-18,Kasaragod,3,0,0,3
2021-12-18,Kollam,5,0,0,5
2021-12-18,Kottayam,2,0,0,2
2021-12-18,Kozhikode,3,0,0,3
2021-12-18,Malappuram,0,0,0,0
2021-12-18,Palakkad,4,0,0,4
2021-12-18,Pathanamthitta,0,0,0,0
2021-12-18,Thiruvananthapuram,3,92,0,95
2021-12-18,Thrissur,3,42,0,45
2021-12-18,Wayanad,0,18,0,18
2021-12-18,total,43,175,0,218
2021-12-19,Alappuzha,1,14,0,15
2021-12-19,Ernakulam,0,10,0,10
2021-12-19,Idukki,0,0,0,0
2021-12-19,Kannur,1,26,0,27
2021-12-19,Kasaragod,0,0,0,0
2021-12-19,Kollam,3,0,0,3
2021-12-19,Kottayam,2,0,0,2
2021-12-19,Kozhikode,0,18,0,18
2021-12-19,Malappuram,0,0,0,0
2021-12-19,Palakkad,1,0,0,1
2021-12-19,Pathanamthitta,0,17,0,17
2021-12-19,Thiruvananthapuram,2,0,0,2
2021-12-19,Thrissur,1,0,0,1
2021-12-19,Wayanad,0,0,0,0
2021-12-19,total,11,85,0,96
2021-12-20,Alappuzha,1,96,0,97
2021-12-20,Ernakulam,0,32,0,32
2021-12-20,Idukki,6,0,0,6
2021-12-20,Kannur,0,54,0,54
2021-12-20,Kasaragod,0,0,0,0
2021-12-20,Kollam,0,0,0,0
2021-12-20,Kottayam,1,61,0,62
2021-12-20,Kozhikode,0,54,0,54
2021-12-20,Malappuram,0,83,0,83
2021-12-20,Palakkad,1,0,0,1
2021-12-20,Pathanamthitta,3,0,0,3
2021-12-20,Thiruvananthapuram,0,25,0,25
2021-12-20,Thrissur,1,0,0,1
2021-12-20,Wayanad,1,0,0,1
2021-12-20,total,14,405,0,419
2021-12-21,Alappuzha,1,25,0,26
2021-12-21,Ernakulam,0,28,0,28
2021-12-21,Idukki,1,36,0,37
2021-12-21,Kannur,6,7,0,13
2021-12-21,Kasaragod,0,0,0,0
2021-12-21,Kollam,9,0,0,9
2021-12-21,Kottayam,1,18,0,19
2021-12-21,Kozhikode,3,0,0,3
2021-12-21,Malappuram,3,45,0,48
2021-12-21,Palakkad,2,2,0,4
2021-12-21,Pathanamthitta,1,0,0,1
2021-12-21,Thiruvananthapuram,6,34,0,40
2021-12-21,Thrissur,0,0,0,0
2021-12-21,Wayanad,0,5,0,5
2021-12-21,total,33,200,0,233
2021-12-22,Alappuzha,0,6,0,6
2021-12-22,Ernakulam,7,81,0,88
2021-12-22,Idukki,0,16,0,16
2021-12-22,Kannur,12,1,0,13
2021-12-22,Kasaragod,0,0,0,0
2021-12-22,Kollam,1,167,0,168
2021-12-22,Kottayam,3,33,0,36
2021-12-22,Kozhikode,2,0,0,2
2021-12-22,Malappuram,0,1,0,1
2021-12-22,Palakkad,2,10,0,12
2021-12-22,Pathanamthitta,5,0,0,5
2021-12-22,Thiruvananthapuram,0,32,0,32
2021-12-22,Thrissur,4,0,0,4
2021-12-22,Wayanad,0,0,0,0
2021-12-22,total,36,347,0,383
2021-12-23,Alappuzha,0,61,0,61
2021-12-23,Ernakulam,8,0,0,8
2021-12-23,Idukki,6,0,0,6
2021-12-23,Kannur,14,7,0,21
2021-12-23,Kasaragod,0,0,0,0
2021-12-23,Kollam,2,0,0,2
2021-12-23,Kottayam,10,0,0,10
2021-12-23,Kozhikode,0,0,0,0
2021-12-23,Malappuram,0,47,0,47
2021-12-23,Palakkad,2,34,0,36
2021-12-23,Pathanamthitta,1,0,0,1
2021-12-23,Thiruvananthapuram,5,4,0,9
2021-12-23,Thrissur,2,116,0,118
2021-12-23,Wayanad,4,0,0,4
2021-12-23,total,54,269,0,323
2021-12-24,Alappuzha,0,32,0,32
2021-12-24,Ernakulam,11,0,0,11
2021-12-24,Idukki,0,0,0,0
2021-12-24,Kannur,5,34,0,39
2021-12-24,Kasaragod,0,0,0,0
2021-12-24,Kollam,0,0,0,0
2021-12-24,Kottayam,2,0,0,2
2021-12-24,Kozhikode,2,0,0,2
2021-12-24,Malappuram,3,66,0,69
2021-12-24,Palakkad,0,47,0,47
2021-12-24,Pathanamthitta,1,22,0,23
2021-12-24,Thiruvananthapuram,4,0,0,4
2021-12-24,Thrissur,3,110,0,113
2021-12-24,Wayanad,0,0,0,0
2021-12-24,total,31,311,0,342
2021-12-25,Alappuzha,1,69,0,70
2021-12-25,Ernakulam,2,3,0,5
2021-12-25,Idukki,0,0,0,0
2021-12-25,Kannur,0,0,0,0
2021-12-25,Kasaragod,0,0,0,0
2021-12-25,Kollam,5,0,0,5
2021-12-25,Kottayam,0,0,0,0
2021-12-25,Kozhikode,0,0,0,0
2021-12-25,Malappuram,0,3,0,3
2021-12-25,Palakkad,0,4,0,4
2021-12-25,Pathanamthitta,0,21,0,21
2021-12-25,Thiruvananthapuram,2,4,0,6
2021-12-25,Thrissur,1,0,0,1
2021-12-25,Wayanad,0,0,0,0
2021-12-25,total,11,104,0,115
2021-12-26,Alappuzha,6,166,0,172
2021-12-26,Ernakulam,3,34,0,37
2021-12-26,Idukki,0,0,0,0
2021-12-26,Kannur,4,0,0,4
2021-12-26,Kasaragod,0,0,0,0
2021-12-26,Kollam,0,0,0,0
2021-12-26,Kottayam,3,0,0,3
2021-12-26,Kozhikode,0,0,0,0
2021-12-26,Malappuram,0,15,0,15
2021-12-26,Palakkad,0,37,0,37
2021-12-26,Pathanamthitta,0,0,0,0
2021-12-26,Thiruvananthapuram,0,0,0,0
2021-12-26,Thrissur,0,0,0,0
2021-12-26,Wayanad,0,0,0,0
2021-12-26,total,16,252,0,268
2021-12-27,Alappuzha,0,5,0,5
2021-12-27,Ernakulam,2,58,0,60
2021-12-27,Idukki,0,0,0,0
2021-12-27,Kannur,2,12,0,14
2021-12-27,Kasaragod,0,0,0,0
2021-12-27,Kollam,0,0,0,0
2021-12-27,Kottayam,0,106,0,106
2021-12-27,Kozhikode,2,0,0,2
2021-12-27,Malappuram,0,0,0,0
2021-12-27,Palakkad,2,22,0,24
2021-12-27,Pathanamthitta,8,0,0,8
2021-12-27,Thiruvananthapuram,5,0,0,5
2021-12-27,Thrissur,0,0,0,0
2021-12-27,Wayanad,2,10,0,12
2021-12-27,total,23,213,0,236
2021-12-28,Alappuzha,0,73,0,73
2021-12-28,Ernakulam,5,42,0,47
2021-12-28,Idukki,1,0,0,1
2021-12-28,Kannur,6,9,0,15
2021-12-28,Kasaragod,8,0,0,8
2021-12-28,Kollam,5,0,0,5
2021-12-28,Kottayam,3,4,0,7
2021-12-28,Kozhikode,3,0,0,3
2021-12-28,Malappuram,0,52,0,52
2021-12-28,Palakkad,0,26,0,26
2021-12-28,Pathanamthitta,0,0,0,0
2021-12-28,Thiruvananthapuram,7,0,0,7
2021-12-28,Thrissur,0,0,0,0
2021-12-28,Wayanad,0,0,0,0
2021-12-28,total,38,206,0,244
2021-12-29,Alappuzha,0,1,0,1
2021-12-29,Ernakulam,1,66,0,67
2021-12-29,Idukki,0,38,0,38
2021-12-29,Kannur,0,18,0,18
2021-12-29,Kasaragod,0,14,0,14
2021-12-29,Kollam,3,0,0,3
2021-12-29,Kottayam,2,46,0,48
2021-12-29,Kozhikode,1,0,0,1
2021-12-29,Malappuram,0,5,0,5
2021-12-29,Palakkad,1,11,0,12
2021-12-29,Pathanamthitta,1,0,0,1
2021-12-29,Thiruvananthapuram,2,0,0,2
2021-12-29,Thrissur,1,0,0,1
2021-12-29,Wayanad,0,0,0,0
2021-12-29,total,12,199,0,211
2021-12-30,Alappuzha,0,4,0,4
2021-12-30,Ernakulam,0,0,0,0
2021-12-30,Idukki,0,0,0,0
2021-12-30,Kannur,2,9,0,11
2021-12-30,Kasaragod,0,12,0,12
2021-12-30,Kollam,2,0,0,2
2021-12-30,Kottayam,2,0,0,2
2021-12-30,Kozhikode,1,0,0,1
2021-12-30,Malappuram,0,75,0,75
2021-12-30,Palakkad,1,14,0,15
2021-12-30,Pathanamthitta,0,29,0,29
2021-12-30,Thiruvananthapuram,5,6,0,11
2021-12-30,Thrissur,2,0,0,2
2021-12-30,Wayanad,0,0,0,0
2021-12-30,total,15,149,0,164
2021-12-31,Alappuzha,1,9,0,10
2021-12-31,Ernakulam,0,0,0,0
2021-12-31,Idukki,0,0,0,0
2021-12-31,Kannur,1,18,0,19
2021-12-31,Kasaragod,1,12,0,13
2021-12-31,Kollam,0,179,0,179
2021-12-31,Kottayam,2,0,0,2
2021-12-31,Kozhikode,0,2,0,2
2021-12-31,Malappuram,0,15,0,15
2021-12-31,Palakkad,0,66,0,66
2021-12-31,Pathanamthitta,1,0,0,1
2021-12-31,Thiruvananthapuram,3,12,0,15
2021-12-31,Thrissur,0,29,0,29
2021-12-31,Wayanad,2,0,0,2
2021-12-31,total,11,342,0,353
2022-01-01,Alappuzha,0,0,0,0
2022-01-01,Ernakulam,6,0,0,6
2022-01-01,Idukki,3,0,0,3
2022-01-01,Kannur,0,0,0,0
2022-01-01,Kasaragod,1,16,0,17
2022-01-01,Kollam,3,10,0,13
2022-01-01,Kottayam,0,4,0,4
2022-01-01,Kozhikode,1,71,0,72
2022-01-01,Malappuram,0,1,0,1
2022-01-01,Palakkad,1,8,0,9
2022-01-01,Pathanamthitta,2,0,0,2
2022-01-01,Thiruvananthapuram,2,7,0,9
2022-01-01,Thrissur,3,102,0,105
2022-01-01,Wayanad,0,0,0,0
2022-01-01,total,22,219,0,241
2022-01-02,Alappuzha,0,0,0,0
2022-01-02,Ernakulam,3,0,0,3
2022-01-02,Idukki,3,0,0,3
2022-01-02,Kannur,1,0,0,1
2022-01-02,Kasaragod,0,0,0,0
2022-01-02,Kollam,1,0,0,1
2022-01-02,Kottayam,3,13,0,16
2022-01-02,Kozhikode,0,35,0,35
2022-01-02,Malappuram,0,0,0,0
2022-01-02,Palakkad,1,17,0,18
2022-01-02,Pathanamthitta,O,0,0,0
2022-01-02,Thiruvananthapuram,0,1,0,1
2022-01-02,Thrissur,0,0,0,0
2022-01-02,Wayanad,0,0,0,0
2022-01-02,total,12,66,0,78
2022-01-03,Alappuzha,0,1,0,1
2022-01-03,Ernakulam,2,0,0,2
2022-01-03,Idukki,0,0,0,0
2022-01-03,Kannur,7,0,0,7
2022-01-03,Kasaragod,0,4,0,4
2022-01-03,Kollam,6,0,0,6
2022-01-03,Kottayam,0,14,0,14
2022-01-03,Kozhikode,8,0,0,8
2022-01-03,Malappuram,0,17,0,17
2022-01-03,Palakkad,1,0,0,1
2022-01-03,Pathanamthitta,0,0,0,0
2022-01-03,Thiruvananthapuram,4,5,0,9
2022-01-03,Thrissur,1,0,0,1
2022-01-03,Wayanad,1,0,0,1
2022-01-03,total,30,41,0,71
2022-01-04,Alappuzha,0,193,0,193
2022-01-04,Ernakulam,0,8,0,8
2022-01-04,Idukki,0,0,0,0
2022-01-04,Kannur,1,77,0,78
2022-01-04,Kasaragod,0,4,0,4
2022-01-04,Kollam,2,0,0,2
2022-01-04,Kottayam,2,15,0,17
2022-01-04,Kozhikode,4,0,0,4
2022-01-04,Malappuram,10,51,0,61
2022-01-04,Palakkad,0,13,0,13
2022-01-04,Pathanamthitta,5,0,0,0
2022-01-04,Thiruvananthapuram,5,37,0,42
2022-01-04,Thrissur,1,0,0,1
2022-01-04,Wayanad,0,25,0,25
2022-01-04,total,30,423,0,453
2022-01-05,Alappuzha,0,35,0,35
2022-01-05,Ernakulam,4,77,0,81
2022-01-05,Idukki,0,0,0,0
2022-01-05,Kannur,6,5,0,11
2022-01-05,Kasaragod,0,18,0,18
2022-01-05,Kollam,2,0,0,2
2022-01-05,Kottayam,0,8,0,8
2022-01-05,Kozhikode,11,0,0,11
2022-01-05,Malappuram,0,0,0,0
2022-01-05,Palakkad,4,1,0,5
2022-01-05,Pathanamthitta,0,0,0,0
2022-01-05,Thiruvananthapuram,2,85,0,87
2022-01-05,Thrissur,0,0,0,0
2022-01-05,Wayanad,0,0,0,0
2022-01-05,total,29,229,0,258
2022-01-06,Alappuzha,0,10,0,10
2022-01-06,Ernakulam,0,104,0,104
2022-01-06,Idukki,0,0,0,0
2022-01-06,Kannur,5,28,0,33
2022-01-06,Kasaragod,0,9,0,9
2022-01-06,Kollam,1,0,0,1
2022-01-06,Kottayam,5,28,0,33
2022-01-06,Kozhikode,0,6,0,6
2022-01-06,Malappuram,0,4,0,4
2022-01-06,Palakkad,1,1,0,2
2022-01-06,Pathanamthitta,4,0,0,0
2022-01-06,Thiruvananthapuram,1,14,0,15
2022-01-06,Thrissur,0,0,0,0
2022-01-06,Wayanad,0,0,0,0
2022-01-06,total,17,204,0,221
2022-01-07,Alappuzha,0,1,0,1
2022-01-07,Ernakulam,2,25,0,27
2022-01-07,Idukki,1,15,0,16
2022-01-07,Kannur,0,5,0,5
2022-01-07,Kasaragod,0,0,0,0
2022-01-07,Kollam,7,0,0,7
2022-01-07,Kottayam,0,24,0,24
2022-01-07,Kozhikode,4,75,0,79
2022-01-07,Malappuram,7,0,0,7
2022-01-07,Palakkad,2,7,0,9
2022-01-07,Pathanamthitta,1,1,0,0
2022-01-07,Thiruvananthapuram,6,0,0,6
2022-01-07,Thrissur,2,1,0,3
2022-01-07,Wayanad,3,0,0,3
2022-01-07,total,35,154,0,189
2022-01-10,Alappuzha,0,37,0,37
2022-01-10,Ernakulam,5,0,0,5
2022-01-10,Idukki,1,0,0,1
2022-01-10,Kannur,0,11,0,11
2022-01-10,Kasaragod,3,12,0,15
2022-01-10,Kollam,0,0,0,0
2022-01-10,Kottayam,0,35,0,35
2022-01-10,Kozhikode,0,0,0,0
2022-01-10,Malappuram,0,0,0,0
2022-01-10,Palakkad,0,37,0,37
2022-01-10,Pathanamthitta,3,0,0,3
2022-01-10,Thiruvananthapuram,5,15,0,20
2022-01-10,Thrissur,1,0,0,1
2022-01-10,Wayanad,1,0,0,1
2022-01-10,total,19,147,0,166
2022-01-11,Alappuzha,0,2,0,2
2022-01-11,Ernakulam,0,9,0,9
2022-01-11,Idukki,0,1,0,1
2022-01-11,Kannur,3,0,0,3
2022-01-11,Kasaragod,0,18,0,18
2022-01-11,Kollam,2,215,0,217
2022-01-11,Kottayam,1,14,0,15
2022-01-11,Kozhikode,8,0,0,8
2022-01-11,Malappuram,0,0,0,0
2022-01-11,Palakkad,0,7,0,7
2022-01-11,Pathanamthitta,1,0,0,1
2022-01-11,Thiruvananthapuram,4,11,0,15
2022-01-11,Thrissur,0,0,0,0
2022-01-11,Wayanad,0,0,0,0
2022-01-11,total,19,277,0,296
2022-01-12,Alappuzha,0,19,0,19
2022-01-12,Ernakulam,2,14,0,16
2022-01-12,Idukki,0,0,0,0
2022-01-12,Kannur,3,24,0,27
2022-01-12,Kasaragod,0,2,0,2
2022-01-12,Kollam,3,24,0,27
2022-01-12,Kottayam,0,0,0,0
2022-01-12,Kozhikode,0,0,0,0
2022-01-12,Malappuram,0,7,0,7
2022-01-12,Palakkad,1,83,0,84
2022-01-12,Pathanamthitta,2,0,0,0
2022-01-12,Thiruvananthapuram,9,3,0,12
2022-01-12,Thrissur,3,0,0,3
2022-01-12,Wayanad,0,0,0,0
2022-01-12,total,23,176,0,199
2022-01-13,Alappuzha,0,13,0,13
2022-01-13,Ernakulam,0,9,0,9
2022-01-13,Idukki,0,0,0,0
2022-01-13,Kannur,0,0,0,0
2022-01-13,Kasaragod,0,0,0,0
2022-01-13,Kollam,1,0,0,1
2022-01-13,Kottayam,0,0,0,0
2022-01-13,Kozhikode,4,0,0,4
2022-01-13,Malappuram,3,0,0,3
2022-01-13,Palakkad,1,15,0,16
2022-01-13,Pathanamthitta,1,0,0,1
2022-01-13,Thiruvananthapuram,8,16,0,24
2022-01-13,Thrissur,3,43,0,46
2022-01-13,Wayanad,0,0,0,0
2022-01-13,total,21,96,0,117
2022-01-14,Alappuzha,0,0,0,0
2022-01-14,Ernakulam,0,38,0,38
2022-01-14,Idukki,0,0,0,0
2022-01-14,Kannur,2,13,0,15
2022-01-14,Kasaragod,0,18,0,18
2022-01-14,Kollam,1,0,0,1
2022-01-14,Kottayam,4,0,0,4
2022-01-14,Kozhikode,0,0,0,0
2022-01-14,Malappuram,0,21,0,21
2022-01-14,Palakkad,0,40,0,40
2022-01-14,Pathanamthitta,2,0,0,2
2022-01-14,Thiruvananthapuram,10,13,0,23
2022-01-14,Thrissur,1,36,0,37
2022-01-14,Wayanad,0,0,0,0
2022-01-14,total,20,179,0,199
2022-01-15,Alappuzha,0,1,0,1
2022-01-15,Ernakulam,4,12,0,16
2022-01-15,Idukki,2,0,0,2
2022-01-15,Kannur,0,5,0,5
2022-01-15,Kasaragod,0,9,0,9
2022-01-15,Kollam,5,0,0,5
2022-01-15,Kottayam,0,0,0,0
2022-01-15,Kozhikode,0,36,0,36
2022-01-15,Malappuram,0,13,0,13
2022-01-15,Palakkad,2,0,0,2
2022-01-15,Pathanamthitta,0,0,0,0
2022-01-15,Thiruvananthapuram,2,13,0,15
2022-01-15,Thrissur,0,0,0,0
2022-01-15,Wayanad,2,0,0,2
2022-01-15,total,17,89,0,106
2022-01-16,Alappuzha,2,0,0,2
2022-01-16,Ernakulam,2,18,0,20
2022-01-16,Idukki,0,0,0,0
2022-01-16,Kannur,0,0,0,0
2022-01-16,Kasaragod,0,0,0,0
2022-01-16,Kollam,0,0,0,0
2022-01-16,Kottayam,0,3,0,3
2022-01-16,Kozhikode,0,37,0,37
2022-01-16,Malappuram,0,13,0,13
2022-01-16,Palakkad,0,36,0,36
2022-01-16,Pathanamthitta,0,0,0,0
2022-01-16,Thiruvananthapuram,4,43,0,47
2022-01-16,Thrissur,0,0,0,0
2022-01-16,Wayanad,0,0,0,0
2022-01-16,total,8,150,0,158
2022-01-17,Alappuzha,0,0,0,0
2022-01-17,Ernakulam,0,26,0,26
2022-01-17,Idukki,0,0,0,0
2022-01-17,Kannur,0,12,0,12
2022-01-17,Kasaragod,0,6,0,6
2022-01-17,Kollam,1,0,0,1
2022-01-17,Kottayam,2,0,0,2
2022-01-17,Kozhikode,6,0,0,6
2022-01-17,Malappuram,0,0,0,0
2022-01-17,Palakkad,4,0,0,4
2022-01-17,Pathanamthitta,1,0,0,1
2022-01-17,Thiruvananthapuram,3,10,0,13
2022-01-17,Thrissur,1,0,0,1
2022-01-17,Wayanad,0,0,0,0
2022-01-17,total,18,54,0,72
2022-01-18,Alappuzha,0,2,0,2
2022-01-18,Ernakulam,3,53,0,56
2022-01-18,Idukki,4,0,0,4
2022-01-18,Kannur,3,0,0,3
2022-01-18,Kasaragod,0,0,0,0
2022-01-18,Kollam,2,0,0,2
2022-01-18,Kottayam,0,12,0,12
2022-01-18,Kozhikode,0,0,0,0
2022-01-18,Malappuram,10,1,0,11
2022-01-18,Palakkad,4,0,0,4
2022-01-18,Pathanamthitta,1,0,0,1
2022-01-18,Thiruvananthapuram,10,15,0,25
2022-01-18,Thrissur,1,0,0,1
2022-01-18,Wayanad,1,0,0,1
2022-01-18,total,39,83,0,122
2022-01-19,Alappuzha,0,0,0,0
2022-01-19,Ernakulam,3,26,0,29
2022-01-19,Idukki,0,0,0,0
2022-01-19,Kannur,5,0,0,5
2022-01-19,Kasaragod,0,0,0,0
2022-01-19,Kollam,0,0,0,0
2022-01-19,Kottayam,4,12,0,16
2022-01-19,Kozhikode,10,0,0,10
2022-01-19,Malappuram,13,7,0,20
2022-01-19,Palakkad,1,19,0,20
2022-01-19,Pathanamthitta,3,0,0,3
2022-01-19,Thiruvananthapuram,6,21,0,27
2022-01-19,Thrissur,4,0,0,4
2022-01-19,Wayanad,0,0,0,0
2022-01-19,total,49,85,0,134
2022-01-20,Alappuzha,0,0,0,0
2022-01-20,Ernakulam,8,0,0,8
2022-01-20,Idukki,0,0,0,0
2022-01-20,Kannur,6,6,0,12
2022-01-20,Kasaragod,0,0,0,0
2022-01-20,Kollam,5,220,0,225
2022-01-20,Kottayam,0,23,0,23
2022-01-20,Kozhikode,4,0,0,4
2022-01-20,Malappuram,1,1,0,2
2022-01-20,Palakkad,1,2,0,3
2022-01-20,Pathanamthitta,3,0,0,3
2022-01-20,Thiruvananthapuram,4,4,0,8
2022-01-20,Thrissur,0,53,0,53
2022-01-20,Wayanad,0,0,0,0
2022-01-20,total,32,309,0,341
2022-01-21,Alappuzha,0,1,0,1
2022-01-21,Ernakulam,5,0,0,5
2022-01-21,Idukki,0,0,0,0
2022-01-21,Kannur,0,10,0,10
2022-01-21,Kasaragod,2,4,0,6
2022-01-21,Kollam,0,0,0,0
2022-01-21,Kottayam,12,34,0,46
2022-01-21,Kozhikode,0,0,0,0
2022-01-21,Malappuram,1,3,0,4
2022-01-21,Palakkad,1,16,0,17
2022-01-21,Pathanamthitta,4,0,0,4
2022-01-21,Thiruvananthapuram,5,5,0,10
2022-01-21,Thrissur,3,0,0,3
2022-01-21,Wayanad,0,0,0,0
2022-01-21,total,33,73,0,106
2022-01-22,Alappuzha,17,0,0,17
2022-01-22,Ernakulam,13,0,0,13
2022-01-22,Idukki,0,0,0,0
2022-01-22,Kannur,5,0,0,5
2022-01-22,Kasaragod,0,4,0,4
2022-01-22,Kollam,1,0,0,1
2022-01-22,Kottayam,0,0,0,0
2022-01-22,Kozhikode,5,57,0,62
2022-01-22,Malappuram,4,1,0,5
2022-01-22,Palakkad,6,0,0,6
2022-01-22,Pathanamthitta,2,0,0,2
2022-01-22,Thiruvananthapuram,14,0,0,14
2022-01-22,Thrissur,3,0,0,3
2022-01-22,Wayanad,0,0,0,0
2022-01-22,total,70,62,0,132
